0 0 0 0 0 0 0 0 0 0 0 0 0 0 0 0 0 0 0 0
0 3 7 7 7 7 7 7 7 7 7 7 7 7 7 7 7 4 0 0
0 8 1 1 1 1 1 1 1 1 1 1 1 1 1 1 1 8 0 0
0 8 1 1 1 1 1 1 1 1 1 1 1 1 1 1 1 8 0 0
0 8 1 1 1 1 1 3 7 7 7 7 7 7 4 1 1 8 0 0
0 8 1 1 1 1 1 8 0 0 0 0 0 0 8 1 1 8 0 0
0 8 1 1 1 1 1 8 0 3 7 7 7 7 5 1 1 6 4 0
0 8 1 1 1 1 1 8 0 8 2 2 2 2 2 2 2 2 8 0
0 6 7 4 1 1 3 5 0 8 2 2 2 2 2 2 2 2 8 0
0 0 0 6 7 7 5 0 0 8 2 2 2 2 2 2 2 2 8 0
0 0 0 0 0 0 0 0 0 8 2 2 2 2 2 2 2 2 8 0
0 0 0 0 0 0 0 0 0 8 2 2 2 2 2 2 2 2 8 0
0 0 0 0 0 0 0 0 0 6 4 1 1 3 7 7 7 7 5 0
0 0 0 0 0 0 0 0 0 0 8 1 1 8 0 0 0 0 0 0
0 0 0 0 0 0 0 0 0 0 8 1 1 8 0 0 0 0 0 0