10 10 10 10 10 10 10 10 10 10 10 10 10 10 10 10 10 10 10 10 10 10 10 10 10 10 10 10 10 10 10 10 10 10 10 10 10 10 10 10 10 10 10 10 10 10 10 10 10 10
10 13 17 17 17 17 17 14 10 10 10 10 10 10 13 17 17 17 17 17 14 10 10 10 10 10 10 10 10 13 17 17 17 17 17 14 10 10 10 10 10 10 10 10 10 10 10 10 10 10
10 18 11 11 11 11 11 18 10 10 10 10 10 10 18 12 12 12 12 12 18 10 10 10 10 10 10 10 10 18 11 11 11 11 11 18 10 10 10 10 10 10 10 10 10 10 10 10 10 10
10 18 11 11 11 11 11 18 10 10 10 10 10 10 18 12 12 12 12 12 18 10 10 10 10 10 10 10 10 18 11 11 11 11 11 18 10 10 10 10 10 10 10 10 10 10 10 10 10 10
10 18 11 11 11 11 11 18 10 10 10 10 10 10 18 12 12 12 12 12 18 10 10 10 10 10 10 10 10 18 11 11 11 11 11 18 10 10 10 10 10 10 10 10 10 10 10 10 10 10
10 18 11 11 11 11 11 18 10 10 10 10 10 10 18 12 12 12 12 12 18 10 10 10 10 10 10 10 10 18 11 11 11 11 11 18 10 10 10 10 10 10 10 10 10 10 10 10 10 10
10 18 11 11 11 11 11 18 10 10 10 10 10 10 18 12 12 12 12 12 18 10 10 10 10 10 10 10 10 18 11 11 11 11 11 18 10 10 10 10 10 10 10 10 10 10 10 10 10 10
10 18 11 13 17 17 17 15 10 10 10 10 10 10 18 11 13 17 17 17 15 10 10 10 10 10 10 10 10 16 17 14 11 13 17 15 10 10 10 10 10 10 10 10 10 10 10 10 10 10
10 18 11 18 10 10 10 10 10 10 10 10 10 10 18 11 18 10 10 10 10 10 10 10 10 10 10 10 10 10 10 18 11 18 10 10 10 10 10 10 10 10 10 10 10 10 10 10 10 10
10 18 11 18 10 10 10 10 10 10 10 10 10 10 18 11 18 10 10 10 10 10 10 10 10 10 10 10 10 10 10 18 11 18 10 10 10 10 10 10 10 10 10 10 10 10 10 10 10 10
10 18 11 18 10 10 10 10 10 10 10 10 10 10 18 11 18 10 10 10 10 10 10 10 10 10 10 10 10 10 10 18 11 18 10 10 10 10 10 10 10 10 10 10 10 10 10 10 10 10
10 18 11 18 10 10 10 10 10 10 10 10 10 10 18 11 18 10 10 10 10 10 10 10 10 10 10 10 10 10 10 18 11 18 10 10 10 10 10 10 10 10 10 10 10 10 10 10 10 10
10 18 11 18 10 10 10 10 10 10 10 10 10 10 18 11 18 10 10 10 10 10 10 10 10 10 10 10 10 10 10 18 11 18 10 10 10 10 10 10 10 10 10 10 10 10 10 10 10 10
10 18 11 18 10 10 10 10 10 10 10 10 10 10 18 11 18 10 10 10 10 10 10 10 10 10 10 10 10 10 10 18 11 18 10 10 10 10 10 10 10 10 10 10 10 10 10 10 10 10
10 18 11 18 10 10 10 10 10 10 10 10 10 10 18 11 18 10 10 10 10 10 10 10 10 10 10 10 10 10 10 18 11 18 10 10 10 10 10 10 10 10 10 10 10 10 10 10 10 10
10 18 11 18 10 10 10 10 10 10 10 10 10 10 18 11 18 10 10 10 10 10 10 10 10 10 10 10 10 10 10 18 11 18 10 10 10 10 10 10 10 10 10 10 10 10 10 10 10 10
10 18 11 16 17 17 17 17 17 17 17 17 17 17 15 11 16 17 17 17 17 17 17 17 17 17 17 17 17 17 17 15 11 16 17 17 17 17 17 17 17 17 17 17 17 17 17 14 10 10
10 18 11 11 11 11 11 11 11 11 11 11 11 11 11 11 11 11 11 11 11 11 11 11 11 11 11 11 11 11 11 11 11 11 11 11 11 11 11 11 11 11 11 11 11 11 11 18 10 10
10 16 17 17 14 11 13 17 17 17 17 17 17 17 14 11 13 17 17 17 17 17 17 17 17 17 17 17 17 17 17 17 17 17 17 17 17 17 17 17 17 14 11 11 11 11 11 18 10 10
10 10 10 10 18 11 18 10 10 10 10 10 10 10 18 11 18 10 10 10 10 10 10 10 10 10 10 10 10 10 10 10 10 10 10 10 10 10 10 10 10 18 11 11 11 11 11 18 10 10
10 10 10 10 18 11 18 10 10 10 10 10 10 10 18 11 18 10 10 10 10 10 10 10 10 10 10 10 10 10 10 10 10 10 10 10 10 10 10 10 10 18 11 11 11 11 11 18 10 10
10 10 10 10 18 11 18 10 10 10 10 10 10 10 18 11 18 10 10 10 10 10 10 10 10 10 10 10 10 10 10 10 10 10 10 10 10 10 10 10 10 18 11 11 11 11 11 18 10 10
10 10 10 10 18 11 18 10 10 10 10 10 10 10 18 11 18 10 10 10 10 10 10 10 10 10 10 10 10 10 10 10 10 10 10 10 10 10 10 10 10 18 11 11 11 11 11 18 10 10
10 10 10 10 18 11 18 10 10 10 10 10 10 10 18 11 18 10 10 10 10 10 10 10 10 10 10 10 10 10 10 10 10 10 10 10 10 10 10 10 10 16 17 17 17 17 17 15 10 10
10 10 10 10 18 11 18 10 10 10 10 10 10 10 18 11 18 10 10 10 10 10 10 10 10 10 10 10 10 10 10 10 10 10 10 10 10 10 10 10 10 10 10 10 10 10 10 10 10 10
10 10 10 10 18 11 18 10 10 10 10 10 10 10 18 11 18 10 10 10 10 10 10 10 10 10 10 10 10 10 10 10 10 10 10 10 10 10 10 10 10 10 10 10 10 10 10 10 10 10
10 10 10 10 18 11 18 10 10 10 10 10 10 10 18 11 18 10 10 10 10 10 10 10 10 10 10 10 10 10 10 10 10 10 10 10 10 10 10 10 10 10 10 10 10 10 10 10 10 10
10 10 10 10 18 11 18 10 10 10 10 10 10 10 18 11 18 10 10 10 10 10 10 10 10 10 10 10 10 10 10 10 10 10 10 10 10 10 10 10 10 10 10 10 10 10 10 10 10 10
10 13 17 17 15 11 16 17 17 14 10 10 10 10 18 11 18 10 10 10 10 10 10 10 10 10 10 10 10 10 10 10 10 10 10 10 10 10 10 10 10 10 10 10 10 10 10 10 10 10
10 18 12 12 12 12 12 12 12 18 10 10 10 10 18 11 18 10 10 10 10 10 10 10 10 10 10 10 10 10 10 10 10 10 10 10 10 10 10 10 10 10 10 10 10 10 10 10 10 10
10 18 12 12 12 12 12 12 12 18 10 10 10 10 18 11 16 17 17 17 17 17 17 17 17 17 17 17 17 17 17 17 17 17 17 17 17 17 14 10 10 10 10 10 10 10 10 10 10 10
10 18 12 12 12 12 12 12 12 18 10 10 10 10 18 11 11 11 11 11 11 11 11 11 11 11 11 11 11 11 11 11 11 11 11 11 11 11 18 10 10 10 10 10 10 10 10 10 10 10
10 18 12 12 12 12 12 12 12 18 10 10 10 10 16 17 17 17 17 17 14 11 13 17 17 17 17 17 17 17 17 17 17 17 17 17 14 11 18 10 10 10 10 10 10 10 10 10 10 10
10 18 12 12 12 12 12 12 12 18 10 10 10 10 10 10 10 10 10 10 18 11 18 10 10 10 10 10 10 10 10 10 10 10 10 10 18 11 18 10 10 10 10 10 10 10 10 10 10 10
10 16 17 17 14 11 13 17 17 15 10 10 10 10 10 10 10 10 10 10 18 11 18 10 10 10 10 10 10 10 10 10 10 10 10 10 18 11 18 10 10 10 10 10 10 10 10 10 10 10
10 10 10 10 18 11 18 10 10 10 10 10 10 10 10 10 10 10 10 10 18 11 18 10 10 10 10 10 10 10 10 10 10 10 10 10 18 11 18 10 10 10 10 10 10 10 10 10 10 10
13 17 14 10 18 11 18 10 10 10 10 10 10 10 10 10 10 10 10 10 18 11 18 10 10 10 10 10 10 10 10 10 10 10 10 10 18 11 18 10 10 10 10 10 10 10 10 10 10 10
18 21 18 10 18 11 18 10 10 10 10 10 10 10 10 10 10 10 10 10 18 11 18 10 10 10 10 10 10 10 10 10 10 10 10 10 18 11 18 10 10 10 10 10 10 10 10 10 10 10
18 11 18 10 18 11 18 10 10 10 10 10 10 10 10 10 10 10 10 10 18 11 18 10 10 10 10 10 10 10 10 10 10 10 10 10 18 11 18 10 10 10 10 10 10 10 10 10 10 10
18 11 18 10 18 11 18 10 10 10 10 10 10 10 10 10 10 10 10 10 18 11 18 10 10 10 10 10 10 10 10 10 10 10 10 10 18 11 18 10 10 10 10 10 10 10 10 10 10 10
18 11 16 17 15 11 18 10 10 10 10 10 10 10 10 10 10 10 10 10 18 11 18 10 10 10 10 10 10 10 10 10 10 10 10 10 18 11 18 10 10 10 10 10 10 10 10 10 10 10
18 11 11 11 11 11 18 10 10 10 10 10 10 10 10 10 10 10 10 10 18 11 18 10 10 10 10 10 10 10 10 10 10 10 10 10 18 11 18 10 10 10 10 10 10 10 10 10 10 10
18 11 11 11 11 11 18 10 10 10 10 10 10 10 10 10 10 10 10 10 18 11 18 10 10 10 10 10 10 10 10 10 10 10 10 10 18 11 18 10 10 10 10 10 10 10 10 10 10 10
16 17 17 17 17 17 15 10 10 10 10 10 10 10 10 10 10 10 10 10 18 11 18 10 10 10 10 10 10 10 10 10 10 10 10 10 18 11 18 10 10 10 10 10 10 10 10 10 10 10
10 10 10 10 10 10 10 10 10 10 10 10 10 10 10 10 10 10 10 13 15 11 16 17 14 10 10 10 10 10 10 10 10 10 10 13 15 11 16 17 14 10 10 10 10 10 10 10 10 10
10 10 10 10 10 10 10 10 10 10 10 10 10 10 10 10 10 10 10 18 11 11 11 11 18 10 10 10 10 10 10 10 10 10 10 18 11 11 11 11 18 10 10 10 10 10 10 10 10 10
10 10 10 10 10 10 10 10 10 10 10 10 10 10 10 10 10 10 10 18 11 11 11 11 18 10 10 10 10 10 10 10 10 10 10 18 11 11 11 11 18 10 10 10 10 10 10 10 10 10
10 10 10 10 10 10 10 10 10 10 10 10 10 10 10 10 10 10 10 18 11 11 11 11 18 10 10 10 10 10 10 10 10 10 10 18 11 19 11 11 18 10 10 10 10 10 10 10 10 10
10 10 10 10 10 10 10 10 10 10 10 10 10 10 10 10 10 10 10 18 11 11 11 11 18 10 10 10 10 10 10 10 10 10 10 18 11 11 11 11 18 10 10 10 10 10 10 10 10 10
10 10 10 10 10 10 10 10 10 10 10 10 10 10 10 10 10 10 10 16 17 17 17 17 15 10 10 10 10 10 10 10 10 10 10 16 17 17 17 17 15 10 10 10 10 10 10 10 10 10